################################################################
#.....................####.................................#####
#.....................####.................................#####
#.....................####.................................#####
#.....................####.................................#####
#.....................####.................................#####
#.....................####.................................#####
#.....................####.................................#####
#.....................####.................................#####
#.....................####.................................#####
#.....................####.................................#####
#.....................####.................................#####
#.....................####.................................#####
#.....................####.....................................#
#.....................####................####.................#
#.....................####................####.................#
#.....................####................####.................#
#.....................####................####.................#
#.........................................####.................#
#.........................................####.................#
#.........................................####.................#
#.........................................####.................#
#.........................................####.................#
#.........................................####.................#
#........####.............................####.................#
#........####.............................####.................#
#........####.............................####.................#
#........####.............................####.................#
#........####.............................####.................#
#........####.............................####.................#
#........####.............................####.................#
#........####.............................####.................#
#........####.............................####.................#
#........####.............................####.................#
#........####.............................####.................#
#........####.............................####.................#
#........####.............................####.................#
#........####.............................####.................#
#........####.............................####.................#
################################################################
